                                                          ######  ##############
                                                          ##  ##  ##          ##
                                                          ##  ##  ######  ######
                                                          ##  ##      ##  ##    
              @@########  ######                      ######  ##########  ##    
                      ##  ##  ##                      ##                  ##    
                      ######  ##          ##############          ######  ##    
                              ##          ##                      ##  ##  ##    
                      ##########      ######  ######          ######  ######    
                      ##              ##      ##  ##          ##                
                      ##############  ##  ######  ##          ##                
                                  ##  ##  ##      ##          ##                
                              ######  ##  ##  ######      ######      ######    
                              ##      ##  ##  ##          ##          ##  ##    
                              ##########  ##  ##          ##          ##  ######
                                          ##  ##          ##          ##      ##
                                      ######  ##      ######      ######  ######
                                      ##      ##      ##          ##      ##    
                                      ##      ##      ##  ##########      ######
                                      ##      ##      ##  ##                  ##
                                      ####00  ##      ######      ##############
                                              ##                  ##            
                                          ######  ##################            
                                          ##      ##                            
                                      ######      ##                            
                                      ##          ##                            
                                      ##  ##########                            
                                      ##  ##                                    
                                      ######                                    
